 ##### 
## . ##
#  $  #
#.$*$.#
#  $  #
## @ ##
 ##.## 
  ###  
