###########
#.       .#
#         ########
# @  $           #
#    $           #
#    $   .########
#         #
###########
